NO textures/backroom.xpm
SO textures/backroom.xpm
WE textures/backroom.xpm
EA textures/backroom.xpm

F 210,198,156
C 144,134,101

111111111111111111111
100000000000000000001
100000111001111100001
100000000010000100001
1000000000000001000011111111
100000000N000001000010000001
1000000000000000000010000001
1000001111111000000010000001
1000000000001000000000000001
1000000000001000000000000001
1111111111001111111110000001
1111111111001111111110000001
1000000000001000000011100111
1000001110011111000000000001
1000000000100000000010000001
1000000000000000000011111111
111111111111111111111111