NO textures/wood1.xpm
SO textures/wood2.xpm
WE textures/wood3.xpm
EA textures/wood4.xpm

F 81,41,28
C 53,168,230

111111111111111111111
100000000000000000001
100000111001111100001
100000000010000000001
100000000000000000001
100000000N00000000001
100000000000000000001
100000000000000000001
100000000000000000001
100000000000000000001
111111111111111111111