NO textures/wood1.xpm
SO textures/wood2.xpm
WE textures/wood3.xpm
EA textures/wood4.xpm

F 81,41,28
C 53,168,230

                      1111111111111
111111                1000000000001
100001     1111111111110000000000011111
100001     1000000000010000000000010001
1000001    10000000000000000N0000000001
1000001    1000000000010000000000010001
1111101111 100011111111000000000001
1000000001110001      1111111111111
1111111100000111
1111111111111111